EWWWWWEEE
EWEEEWWWW
EWEEEWEEW
EWWEEEETW
WWWEWWWTW
WEBEWEWTW
WEBBWEWWW
WPEEWEEEE
WWWWWEEEE