WWWWWWWWWWWWEE
WTTEEWEEEEEWWW
WTTEEWEBEEBEEW
WTTEEWBWWWWEEW
WTTEEEEPEWWEEW
WTTEEWEWEEBEWW
WWWWWWEWWBEBEW
EEWEBEEBEBEBEW
EEWEEEEWEEEEEW
EEWWWWWWWWWWWW