WWWWWWWE
WEEEEEWE
WTTEEEEW
WPBEBEWW
WWWWWWWW